..........
....o.....
...ooo....
....o.....
..........
